


NO misc/cool_textures/1.xpm
SO misc/cool_textures/2.xpm
WE misc/cool_textures/3.xpm

EA misc/cool_textures/4.xpm

F 112,       185,135

C 190,249,255

1111111111111111
10000000000000011 111
1000000000000001
1000001000000001
1000000000000001
10000000000000W1
1111111111111111

 

