NO ./misc/textures/cool_textures/1.xpm
SO ./misc/textures/cool_textures/2.xpm
WE ./misc/textures/cool_textures/3.xpm
EA ./misc/textures/cool_textures/4.xpm
F 220,100,0

111111111111111
1000000000000001
10000000000000001
100N000000000001
1000000000000001
1111111111111111
