NO ./misc/textures/cool_textures/1.xpm
SO ./misc/textures/cool_textures/2.xpm
WE ./misc/textures/cool_textures/3.xpm
EA ./misc/textures/cool_textures/4.xpm
F 220,100,0
C 225,30,0

111111
100W01
111111
